___________N___
___________N___
___________N___
____________NN_
_1__________N2_
____________NN_
_______________
___________N___
___________N___
