     PMO
     BSV
PMMMMIDUMMMMO
BXXXXXXXXXXXV
BXXXXXXXXXXXV
BXXXXXXXXXXXV
BXXXXXXXXXXXV
BXXXXXXXXXXXV
BXXXXXXXXXXXV
BXXXXXXXXXXXV
INNNNPDONNNNU
     BXV
     BxV
     BXV
     BXV
     BXV
     BXV
     BXV
PMMMMIDUMMMMO       PMMMMMMMMMMMMMMMMMMO
BXXXXXXXXXXXV       BXXXXXXXXXXXXXXXXXXV   
BXXXXXXXXXXXV       BXXXXXXXXXXXXXXXXXXV
BXXXXXXXXXXXV       BXXXXXXXXXXXXXXXXXXV
BXXXXXXXXXXXV       BXXXXXXXXXXXXXXXXXXV       PMMMMMMMMMMMO
BXXXXXXXXXXXPMMMMMMMOXXXXXXXXXXXXXXXXXXPMMMMMMMOXXXXXXXXXXXV
BXXXXXXXXXXXDXXXXXXXDXXXXXXXXXXXXXXXXXXDXXXXXXXDXXXXXXXXXXXV
BXXXXXXXXXXXINNNNNNNUXXXXXXXXXXXXXXXXXXINNNNNNNUXXXXXXXXXXXV
BXXXXXXXXXXXV       BXXXXXXXXXXXXXXXXXXV       BXXXXXXXXXXXV
BXXXXXXXXXXXV       BXXXXXXXXXXXXXXXXXXV       BXXXXXXXXXXXV
BXXXXXXXXXXXV       BXXXXXXXXXXXXXXXXXXV       BXXXXXXXXXXXV
BXXXXXXXXXXXV       BXXXXXXXXXXXXXXXXXXV       BXXXXXXXXXXXV
INNNNNNNNNNNU       INNNNNNNNNNNNNNNNNNU       BXXXXXXXXXXXV
                                               BXXXXXHXXXXXV
                                               BXXXXXXXXXXXV
                                               INNNNNZNNNNNU