___________N___
1__________N___
___________N___
____________NN_
____________N__
____________NN_
______________2
___________N___
___________N___
