EEEEEEEEEEEEEEE
EEEEEEEEEEEEEEE
EEEEEEEEEEEEEEE
EWWEEEEEEEEEFFE
ESWEEEEEEEEEFEE
EWWEEEEEEEEEFFE
EEEEEEFFFEEEEEE
EEEEEEFEFEEEEEE
EEEEEEEEEEEEEEE
