_______________
___N______N____
___N______N____
NNN_______N__N_
__________N____
NNN_______N_NN_
___N___________
___N______N____
1__N______N___2
