EEEEEEEEEEEEEEE
EEEEEEEEEEEEEEE
EEEEEEEEEEEEEEE
ENNEEEEEEEEENNE
ESNEEEEEEEEENEE
ENNEEEEEEEEENNE
EEEEEEEEEEEEEEE
EEEEEEEEEEEEEEE
EEEEEEEEEEEEEEE
