_______________
___N______N____
___N______N____
NNN_______N__N_
_1N_______N__2_
NNN_______N_NN_
___N___________
___N______N____
___N______N____
