EEEEEEE1EEEEEEE
EEEEFEEEEEEWEEE
EEEFEEEEEEEWEEE
EEFEFEEEEEEWWEE
EEEFEEEEEEEWEEE
EEFEFEEEEEEWWEE
EEEFEEEEEEEWEEE
EEEEFEEEEEEWEEE
EEEFEEE2EEEWEEE
