EEEEEEEEEEEEEEE
EEEEEEEEEEWEEEE
EEENEEEEEEEEEEE
ENNEEEEEEEEEEWE
EEEEEEEEEEEEE2E
ENNEEEEEEEEEWWE
EEENEEEEEEEEEEE
EEEEEEEEEEWEEEE
EEENEEEEEEWEEEE
