___________F___
___________F___
____________F__
____________FF_
_1__________F2_
____________FF_
____________F__
___________F___
___________F___
