EEENEEEEEEWEEEE
EEENEEEEEEWEEEE
EEENEEEEEEWEEEE
NNNEEEEEEEWEEWE
E1NEEEEEEEWEE2E
NNNEEEEEEEWEWWE
EEENEEEEEEEEEEE
EEENEEEEEEWEEEE
EEENEEEEEEWEEEE
