EEEEEEEEEEWEEEE
EEEEEEEEEEWEEEE
EEENEEEEEEWEEEE
NNNEEEEEEEWEEWE
E1EEEEEEEEWEE2E
NNNEEEEEEEWEWWE
EEENEEEEEEEEEEE
EEEEEEEEEEWEEEE
EEENEEEEEEWEEEE
