EEEEEEEEEEEEEEE
EEEENEEEEEENEEE
EEENEEEEEEENEEE
EENENEEEEEENNEE
EEENEEEEEEENEEE
EENENEEEEEENNEE
EEENEEEEEEENEEE
EEEENEEEEEENEEE
EEENEEEEEEENEEE
