_______________
1_________N____
__________NN___
____________N__
____________N_2
____________N__
__________N__N_
__________N____
__________N____
