_______________
____N_____N____
____N_____N____
NNN_N_____N__N_
3NN_N_______N_4
NNN_N_____N__N_
____N_____N____
____N_____N____
1_________N___2
