EEEEEEEEEEEEEEE
EEEEEEEEEEEEEEE
EEEEEEEEEEEEEEE
ENNEEEEEEEEEFFE
E1NEEEEEEEEEF2E
ENNEEEEEEEEEFFE
EEEEEEFFFEEEEEE
EEEEEEFEFEEEEEE
EEEEEEEEEEEEEEE
