EEEEEEEEEEEEEEE
EEEEEEEEEEEEEEE
EEEEEEEEEEEEEEE
ENNEEEEEEEEENNE
E1NEEEEEEEEEN2E
ENNEEEEEEEEENNE
EEEEEEEEEEEEEEE
EEEEEEEEEEEEEEE
EEEEEEEEEEEEEEE
