EEEEEEEEEEEEEEE
EEEEEEEEEEEEEEE
EEEEEEEEEEEEEEE
EWWEEEEEEEEENNE
ESWEEEEEEEEENEE
EWWEEEEEEEEENNE
EEEEEEEEEEEEEEE
EEEEEEEEEEEEEEE
EEEEEEEEEEEEEEE
