___________N___
1__________N___
___________N___
____________NN_
3___________N_4
____________NN_
______________2
___________N___
___________N___
