~~~~~~~S~~~~~~~
IEEEEEEEEEEEEEI
IEEEEEEEEEEEEEI
IEEEEEEEEEEEEEI
IEEEEEEEEEEEEEI
IEEEEEEEEEEEEEI
IEEEEEEEEEEEEEI
IEEEEEEEEEEEEEI
IIIIIIIIIIIIIII
