~~~~~~~~~~~~~~~
IEEEEEEEEEEEEEI
IEEEEEEEEEEEEEI
INNEEEEEEEEENNI
ISNEEEEEEEEENEI
INNEEEEEEEEENNI
IEEEEEEEEEEEEEI
IEEEEEEEEEEEEEI
IIIIIIIIIIIIIII
