PMMMMMMMMMMMMISUMMMMMMMMMMMMMO
BXXXXXXXXXXXXXXXXXXXXXXXXXXXXV
BXXXXXXXXXXXXXXXXXXXXXXXXXXXXV
BXXXXXXXXXXXXXXXXXXXXXXXXXXXXV
BXXXXXXXXXXXXXXXXXXXXXXXXXXXXV
BXXXXXXXXXXXXXXXXXXXXXXXXXXXXV
BXXXXXXXXXXXXXXXXXXXXXXXXXXXXV
BXXXXXXXXXXXXDXXXXXXXXXXXXXXXV
BXXXXXXXXXXXXXXXXXXXXXXXXXXXXV
BXXXXXXXXXXXXXXXXXXXXXXXXXXXXV
BXXXXXXXXXXXXXXXXXXXXXXXXXXXXV
BXXXXXXXXXXXXXXXXXXXXXXXXXXXXV
BXXXXXXXXXXXXXXXXXXXXXXXXXXXXV
BXXXXXXXXXXXXXXXXXXXXXXXXXXXXV
BXXXXXXXXXXXXXXXXXXXXXXXXXXXXV
BXXXXXXXXXXXXXXXXXXXXXXXXXXXXV
INNNNNNNNNNNNPZONNNNNNNNNNNNNU