~~~~~~~~~~~~~~~
IEEEEEEEEEEEEEI
IEEEEEEEEEEEEEI
INNEEEEEEEEEFFI
ISNEEEEEEEEEFEI
INNEEEEEEEEEFFI
IEEEEEFFFEEEEEI
IEEEEEFEFEEEEEI
IIIIIIIIIIIIIII
