~~~~~~~~~~~~~~~
IEEEEEEEEEEEEEI
IEEEEEEEEEEEEEI
IWWEEEEEEEEEFFI
ISWEEEEEEEEEFEI
IWWEEEEEEEEEFFI
IEEEEEFFFEEEEEI
IEEEEEFEFEEEEEI
IIIIIIIIIIIIIII
