EEEEEEEEEEEEEEE
EEENEEEEEENEEEE
EEENEEEEEENEEEE
NNNEEEEEEENEENE
E1NEEEEEEENEE2E
NNNEEEEEEENENNE
EEENEEEEEEEEEEE
EEENEEEEEENEEEE
EEENEEEEEENEEEE
