_______________
____N_____N____
____N_____N____
NNN_N_____N__N_
__________N____
NNN_______N_NN_
____N__________
____N_____N____
1___N_____N___2
