_______________
______________2
____________N__
____________NNN
3___________N_4
____________NN_
____________N__
___________N___
1__________N___
