_______________
____N_____N____
____N_____N____
NNN_N_____N__N_
____________N__
NNN_______N__N_
____N_____N____
____N_____N____
1___N_____N___2
