~~~~~~~~~~~~~~~
IEEEEEEEEEEEEEI
IEEEEEEEEEEEEEI
IWWEEEEEEEEENNI
ISWEEEEEEEEENEI
IWWEEEEEEEEENNI
IEEEEEEEEEEEEEI
IEEEEEEEEEEEEEI
IIIIIIIIIIIIIII
