_______________
___________N__2
____________N__
____________NN_
3___________N_4
____________NN_
____________N__
___________N___
1__________N___
