_______________
____N_____N____
____N_____N____
NNN_N_____N__N_
_NN_N_______N__
NNN_N_____N__N_
____N_____N____
____N_____N____
1_________N___2
