EEEEEEEEEEEEEEE
EEEEEEEEEEEEEEE
EEEEEEEEEEEEEEE
EWWEEEEEEEEENNE
E1WEEEEEEEEEN2E
EWWEEEEEEEEENNE
EEEEEEEEEEEEEEE
EEEEEEEEEEEEEEE
EEEEEEEEEEEEEEE
