_______________
1_________N____
__________NN___
____________N__
3___________N_4
____________N__
__________N__N_
__________N____
__________N___2
