_________F_____
_________F_____
_________F_F___
____________F__
_1__________F2_
____________F__
_________F_F___
_________F_____
_________F_____
